


HR_TAG



HOME | ADD URL | BANNER EXCHANGE | ADVERTISING | CONTACT
!!! We Never Ask For Payments Via Email !!!












































             











             



































































  Deep Search  - Most Powerful Search Engine on TOR


   Ahima Search  - The Dark Web Search Engine


    Tor|Google - Discover Hidden Services and access to Tor onion sites


    Onionland - Search Hidden Services on the Tor Network


    Lighter - Darl Side of Internet


    Torgle - The Dark Web Search Engine


     



     


     






     


     





     


     






  Digital Den - Digital Den Deep Web Skimming Union!


  Royal Class Cards - Prepaid Visa's We ship From US and Europe.


    Brians Club - FRESH DUMPS & CVV2 CARDS. DAILY UPDATE'S


    YALE LODGE - YALE LODGE - BIGGEST SHOP OF FRESH DUMPS/CVV2/FULLZ/D+P.


    Add Your Link


     





  QF Market - We Offer Fast Transfer's Worldwide.


    Ace Market - Cracked BTC Wallets Private Keys.


    BTC Private Key Shop - High Balance BTC Wallets With Private Keys.


    Hacked WU Transfer's - Delivering our services since 2013.


  MoneyPlus AutoShop  - Hacked Accounts, Carding, CC, Transfers, GiftCards.


  FanDot Market Script  - Full PHP Single Vendor Market Script !


    Add Your Link


     





  The Armory - The Armory DeepWeb Firearm/Explosive's Market place 2021


    Firearms 72 - Guns & Ammo Made Easy, Shipping WorldWide .


  3D Print FGC9 -MK3 - Download A Complete Model Of 3D FGC9 -MK3.


    Add Your Link


     





  HQ Print's - High Quality Banknotes With 20 Years of Experience


    Citizen Of The World - Discover Relocate or immigrate now !


    Counterfeiting Center - Counterfeiting Center Deepweb Counterfeit Market Place.


    Add Your Link


     





    XMatches -  We provide fixed matches we make betting profitable.


    Pure Miner v3 - Most advanced and well coded miner in the market.


    BTC RECOVERY -  Recover Your Stolen BTC From Scammers :)


  Bitcoin Multiplier - Multiply your Bitcoins up to 800% and get rich quickly!


    Add Your Link


     





  Digital Goods - DIGITAL GOODS - BIGGEST SHOP OF FRESH GIFTCARDS.


  Amazon GiftCards  - Amazon GiftCards 75% Discount. Fresh Stock. Everyday Updates


    Add Your Link


     





    Easy Paypal - Easy Profit with Hacked Paypal Accounts


    Add Your Link


     





    NamasteLSD - Insane deals and new products. [Speed, LSD, MDMA, KETA]


  RAVERS DEN - We Specialize In HQ Products Worldwide


    TOM & JERRY - TOM & JERRY | Private Shop.


    Magic Lamp Co - Only The Best HQ Buds, Wax & Shrooms, Dont Miss Out.


  Hungry Eyes - Offical Vendor Store Cocaine & More.


    Add Your Link


     







     





  SecHack - Hire The Most Advanced Hackers Of The Darknet.


    iHack - Customized Phishing Sites + Panel Collect LOGS + FULLZ + CC


    KickAss Forum - KICK-ASS HACKING FORUM


    Ranion - RANION (RaaS) | FUD Ransomware + C&C on Darknet + NO Fees


  Illegal Hacking - DDOS,
hacks, exploits, hacking facebook email or password, and much more


    Add Your Link


     





  Free Ross Ulbricht - We are a group working to free Ross.


  Onion Wallet - Anonymous and secure bitcoin wallet and mixer.


    JAMBLER | BITCOIN MIXER - BITCOIN BLENDER | BITCOIN MIXER


    Coinbase - Buy Crypto Ceurrency Easy Here


    Blockchain - Buy Bitcoin and Blockchain Wallet


    Safe Escrow - Secure escrow for the cryptocurrency world


    TrustBTC Escrow - Eliminate the risk and start an escrow today!


    X-change - Bitcoin & XMR mixing Service Secure and Anonymous


     






    Kowloon Hosting - Hosting with PHP & SQL - Custom Onion


    Ablative Hosting -Free Secured Clearnet and Tor .Onion Web Hosting


    Kaizushi Little Onion - This is a Hosting Service with a Shared Server


    FileForce - Fully nonymous File Sharing Service, 25MB Max-Size


    HDDoro - Image Hosting ... Hosted in Space


    MegaTor - Free Hosting with over 900 File Formats


    Pedoro - Fast Save and Secure Image Hosting


    TorPay -Share Files and Services for Money


    Tortuga - Secure & Anonymous TOR-Based File Hosting



     






    Protonmail -Secure Email Based in Switzerland


    DNMX - Anonymous Email Provider


    Crypto Dog - Private Conversations for Everyone


    Elude - Email Provider with many Features


    Mail2Tor - Free Anonymous E-Mail Service to protect your Privacy


    Polo Mail - Another Secure Email Provider


    SecMail - Service that allows you to Send and Receive Mails without Violating


    Tor Mail -Free and Secured Anonymity Mail Service


    Tor Box - Hidden Mailbox Service only accessible from TOR


     





    Dark Web Links -Latest DeepWeb News with Liinks of Darknet Markets


    Dark Web Magazine - News / Guides / Links


    DarknetLive - The Real Darknet Live


    DeepWeb Feed - Links to the best Darknet Markets


    Flashlight 2.0 - An Info Beam in the Darkweb


    Dark Web Journal - News and Reviews from the DarkNet


     






    Deep Paste - Uncensored Paste Bin


    Core - Forum about The Deep Web


    Darknet Street - See what People are talking about


    Hidden Answers - Deep Web Forum


    Galaxy 3 - Big Deep Web Forum


    Deep Paste v2 - Your Deep-Shit Hoster for Special Shit


    Arcadia - Free Retro Games


    Bible4u - Uncensored Bible for Darknet


    Stronghold - Paste Bin Directory


    We Fight Censorship - Site against Censorship


    Bitcoin Game - More you play, more you win!


    Just Another Library - Books, Courses & Art


    Dark Net Paste - Another Paste Bin


    Beneath VT - Exploring Virginia Tech's steam tunnels and beyond


    The Hidden Irony - Private Blog


    Tor Guide - Instructions for Tor / Deep Web


    Yet Another PasteBin - Post your Stuff Anonymous


    Tor Status - Tor Network Status


     
