

 


TorLinks | .onion Link List


Commercial Links


Introduction
Financial Services
Commercial Goods
Drugs
Domain Services
Erotic

Non-Commercial Links

Services
Hacking
Email
Erotic
Forums
Blogs
Social
Others
Non-English





(ads)



Introduction PointsNon-Commercial Links


GoDark Search | TOP WEB SITES + Verified The easiest and safest way to find the right website. [Verified]
The Hidden Wiki | The Hidden Wiki most recent and updated. [Verified]
Ahmia.fi | Clearnet search engine for Tor Hidden Services.
DuckDuckGo | A Hidden Service that searches the clearnet.
TOR SCAM LIST | The list of scam site, where you can report about other scam sites. Also we have verified links. [Verified]
Torlinks | TorLinks is a moderated replacement for The Hidden Wiki. [Verified]
Not Evil | is a Tor search engine which only indexes hidden services on Tor.
Self-defense Surveillance Guide | Tips, Tools and How-tos for Safer Online Communications (clearnet).
Λ

Financial ServicesCommercial Links


Imperial Market | Prepaid cards (VISA/MasterCard). Cloned Cards. Gift Cards (VISA/Amazon/PayPal). PayPal/Western Union Transfers. Escrow Accepted! [Verified]
Light Money | Discount service of Prepaid Cards, Money Transfers and Gift Cards. [Verified]
Millioner Private Club | Prepaid cards, credit cards, western union and paypal seller. [Verified]
Buy Real Money | Buy best quality cash in multiple currencies: USD, EURO and GBP. Thousands of reviews! [Verified]
Cash Cards | Prepaid VISA / Amex / MasterCards - Western Union and PayPal Moneytransfer within 30 minuntes. [Verified]
Fast Money | Prepaid cards, credit cards, western union and paypal seller. [Verified]
Bankor | Cloned/Prepaid Credit Cards and Money Transfers via PayPal or Western Union Service Since 2015 [Verified]
Team Transfers | PayPal, Western Union and MoneyGram Transfers [Verified]
Goldman Financial Services | Fast and secure money transfers. Express shipping is free. [Verified]
PREMIUM CARDS | Oldest cc vendor, Top quality Us & Eu credit cards! [Verified]
Cash Cow | PrePaid cards, Paypal Transfers and Accounts, Bank Transfers, Western Union Transfers, MoneyGram Transfers, Real Money, Gift Cards Seller! [Verified]
Digital Goods | Best Shop for Gift Cards, Payment Cards, Money Transfer and more. [Verified]
Dark Escrow | It’s our job to sweat the small stuff. We’ll make sure your sale is safeguarded from fraud , while you focus on your business. [Verified]
Cash Machine | Phished PayPal, Neteller, Skrill, BoA, Wells fargo bank Accounts, Paysafecard's, US & EU Credit cards are available here. [Scam]
Global Carding Forum | Escrow Accepted + CashApp, Western Union, Moneygram, Paypal, Zelle, Amazon, Ebay, Wire, Off-Shore Bank, VCC, CC with Pin. [Scam]
Queen Galaxy | #1 Female Carding Shop Since 2011! CashApp, Western Union, Moneygram, Amazon, Wire Transfer, Prepaid, Debit, Credit & More. [Scam]
Bitcards | The most trusted credit cards store in darknet with returning customers. [Scam]
KryptoPayPal | PayPal Cashout Service. Get the account balance back in Bitcoin. [Scam]
TOP Cards | Credit Cards, from the most Trusted Vendor in the union.Fast shipping. [Scam]
Your C.Card Shop | Physical credit cards with High balance available to order. Paypal or bitcoins as payment method. [Scam]
USJUD Counterfeits | EUR, USD Western Union money, any trusted escrow accepted, the most trusted seller. [Scam]
Financial Market | PayPal Western Union Transfers. Escrow Accepted [Scam]
Black&White Cards | High Quality Pre-Paid Debit Cards with PIN. Good Customer Service. Best Deals. [Scam]
Real currency | Finest bills on market. Passes all known tests. Random serials. Only top-notch currency. [Scam]
The Cards World | Get your Financial Freedom Today. [Scam]
PP&CC Money vault | 24/7 automated PayPal & Credit card shop. New stock every day. Safe cashout. [Scam]
Prepaid Cards | Oldest seller on old HW. Fresh stock. 99.9% safe. Worldwide cashout! Express shipping. Escrow. [Scam]
Horizon Store | Automated carding store.Fast replies. 90% cards are valid.< [Scam]
Black Store | Bank cards store with fresh stock and instant delivery. Every deal protected by Escrow service. [Scam]
Queens Cash | Buy Pre-Shredded USD & EURO Currency for a fraction of the value. WE SELL REAL CASH. [Scam]


Λ

Commercial ServicesCommercial Links


Guns Dark Market | Guns market to buy guns, full auto assault rifles, pistols, grenade launchers, etc. [Verified]
Counterfeiting Center | A Store to buy passports, idcards, credit cards, offshore bank accounts, counterfeits money. [Scam]
CStore | Electronics purchased with carded giftcards, Everything Brand new. Full escrow accepted. [Scam]
Apple Palace | low priced Apple Products! [Scam]
Gold & Diamonds | Genuine Gold, Diamonds and Rhino Horn shipped from Germany and USA. [Scam]
Football Money | Fixed football games info. [Scam]
HackingTeam | Hacking as a Service Team. [Scam]
EuroGuns | Your #1 european arms dealer. [Scam]
USfakeIDs | High quality USA Fake Drivers Licenses. [Scam]
Fake Passport ID sale | Website selling qualitative EU/US/AUS/CAN fake passports, ID cards and driver's licenses. [Scam]
Samsungstore | Samsung tablets, smartphones, notebooks with escrow. [Scam]
Kamagra for Bitcoin | Same as Viagra but cheaper! [Scam]
Apples4Bitcoin | Cheap Apple products for Bitcoin. [Scam]
Onion Identity Services | Selling Passports and ID-Cards for Bitcoins. [Scam]
Apple World | Carded iPhones, iPads, Macbooks, iMacs and consoles shipping worldwide. [Scam]
Amazon Cards | Bring dreams to reality with these amazing Amazon gift cards. [Scam]
Mobile Store | Factory unlocked iphones and other smartphones. [Scam]
Cards | Credit cards with high balance [Scam]
Low Balance CC's | Get cheap low balance cards. [Scam]
Bitcoin Fortune | Buy New Bitcoin Miners at a discount. [Scam]
EasyPayPal | Trusted PayPal onion shop with big history. Good prices. [Scam]
Onion shop | Specialized risk-free credit card, Western union and Paypal shop. [Scam]

Λ

DrugsCommercial Links


RealWeed | Site definitely created and runned by people with love to marijuana. If you also love marijuana - you will understand everything. That's all. [Verified]
Greenroad | Biggest marketplace with full working escrow. [Scam]
Weed&Co | Weed/Cigarettes. Prix Bas/Low Price. [Scam]
EuCanna | 'First Class Cannabis Healthcare' - Medical Grade Cannabis Buds, Rick Simpson Oil, Ointments. [Scam]
CannabisUK | UK Cannabis vendor, selling only organic weed. [Scam]
DeDope | German Weed Shop - Weed and Hash from Germany. [Scam]
BitPharma | EU vendor for cocaine, speed, mdma, psychedelics and subscriptions. [Scam]
Brainmagic | Best psychedelics on the darknet. [Scam]
NLGrowers | Coffee Shop grade Cannabis from the netherlands. [Scam]
The Pot Shop | Weed and Pot Shop Trading for longer than a year now! [Scam]
Steroid King | All the steroids you need.< [Scam]
Wacky Weed | Hi Quality Green at Wacky Prices [Scam]

Λ

Domain ServicesCommercial Links


OnionName | Choose your desired domain name prefix, and order the .onion domain, starting from 0.45 mBTC for 8 letters.
Λ

EroticCommercial Links


Darkscandals | Real rape, humiliation, forced videos and much more extreme videos! (Pack 8 is out! More than 1800 video files in the packs).

Λ


ServicesNon-Commercial Links



Hosting

TorVPS Shells | Free torified shell accounts, can be used for .onion hosting, IRC, etc.
SporeStack | API-driven VPS hosting for Bitcoin. Clearnet and hidden Tor hosting.
HomeHosting | A system administrator who can set up your private home server.
Prometheus_Hidden_Services | Payed hosting, provides Virtual Private Server (VPS) with Linux.
Darknet design | Web design (HTML, CSS, PHP) plus graphics design and a few other things.
Daniel's Hosting | Free hosting.

Λ

HackingNon-Commercial Links


HeLL Forum | HeLL Reloaded is back!
RelateList | New era of intelligence.
CODE: GREEN | Ethical hacktivism for a better world. Join us and participate in modern world protests!
Hack Canada | America is a joke and Canada is the punchline. Old-ish hacking site, hosts a few archives.
Hack Place | Site with several books and resources on software development, pentesting and hacking.
We fight censorship | a Reporters Without Borders project that aims to combat censorship and promote the flow of news and information.

Λ

EmailNon-Commercial Links


Protonmail | Swiss based e-mail service, encrypts e-mails locally on your browser. Free and paid accounts.
Mail2Tor | Mail2Tor is a free anonymous e-mail service made to protect your privacy.
TorBox | This is a hidden mailbox service only accessible from TOR without connection with public internet.
Elude.in | Elude.in is a privacy based email service and a Bitcoin/Monero exchange.
BitMessage | Connects bitmessage and e-mail services. Registration only available using the clearweb link.
TorGuerrillaMail | Disposable Temporary E-Mail Address.
Chat with strangers | Talk to random users anonymously.
CTemplar | First ever high end fully encrypted tor email service.
Shielded | Security-focused mailbox hosting with customizable .ONION domain name. Payment by smart escrow (multi-sig contracts or Lightning Network transactions).
Ableonion | Random chat with other tor users.


Books

OnionWarez | Warez forum
The Tor Library | 47 GB. pdf, chm, djvu. Design by Russebertene
Example rendezvous points page | Thomas Paine's ''Common Sense'' and ''The Federalist papers''
Destination Unknown | Small selection. Searchlores, Cryptonomicon, Thelema..
LiberaTor | Making weapons, military training, and related subjects
Free Bibliotheca Alexandrina | English, Spanish and German books
The Laughing Nihilist | Drugs + writing
Mister | Collection of writings, art, selected texts and deeply personal views on philosophy of existence
ParaZite | Collection of forbidden files and howto's (pdf, txt, etc.)
Λ



ForumsNon-Commercial Links


The Stock Insiders | The Oldest and the Largest Insider Trading Forum. The community for exchanging Insider Information about the Publicly Traded Companies.
The Intel Exchange | Know or need to know something? Ask and share at this underground intelligence gathering network.
DNM Avengers | Darknet drug forum with reviews and marketplace discussion.
OnionLand | Discussion forum about all the Darkweb markets related topics.
Dread | Reddit like website.
Λ

BlogsNon-Commercial Links


Tor Metrics | Welcome to Tor Metrics, the primary place to learn interesting facts about the Tor network, the largest deployed anonymity network to date. If something can be measured safely, you'll find it here.
Superkuh | Much information about spectrogram, wireless, and radio.
Beneath VT | Exploring Virginia Tech's steam tunnels and beyond.
Tor Against CP! | Free and clean Tor - Tor users against CP!
Go Beyond | A blog about politics, potatoes, technology, Tor, etc.

Λ

SocialNon-Commercial Links


Connect | Connect is a collective that recognizes and promotes anticapitalism, antiracism, antifascism, antisexism, antimililtarism, and anti-what-the-fuck-ever and the refusal of authoritarianism and hierarchies.
Galaxy3 | Galaxy3 is a new, Social Networking experience for the darknet!
Torbook 2.0 | The Facebook of Tor. Share your memories, connect with others and make friends.
Facebook | The real Facebook's Onion domain. Claim not to keep logs. Trust them at your peril.

Whistleblowing


WikiLeaks

WikiLeaks | DeepWeb mirror of the famous Wikileaks website.
Doxbin | A pastebin for personally identifiable information.
SecureDrop | The open-source whistleblower submission system managed by Freedom of the Press Foundation.
Λ

OthersNon-Commercial Links


DuckDuckGo | metasearch engine with heavy filtering
IIT Underground | Information on and photos of the steam tunnels and roofs at the Illinois Institute of Technology.
Λ

Non-EnglishNon-Commercial Links



Finnish / Suomi

Sipulilauta | A chan
Silkkitie | Silkkitie.
Blue Quarters Forum | Discussion forum

French

French Freedom Zone | Malwares, Hacking, Dev, Esoterisme | Elitisme & Aristocratie.
French Deep Web | an administered and moderate French board (1er forum francophone).

German / Deutsch

Konkret | das linke Magazin: Archiv.
MadIRC | Deutscher IRC-Channel.


Italian / Italiano

BlackHost | A small website developed by an Italian programmer.
New System Disorder | Italian Hackers Community - Stay Tuned!
IDC Reloaded | Italian DarkNet Community.

Polish / Polski

Teczkohen | powrot obrazkowego forum o tematyce stalking.
Polska Cebulka | Najstarsze dzialajace polskie forum.


Spanish

CebollaChan 3.0 | CebollaChan, el tor-chan en Castellano.
TorPez | Foro de seguridad informatica entre otras cosas.

Swedish / Svenska

Moral.Nu | Vad ar moral?
KognitionsKyrkan | Spiritual stuff

Λ







(ads)


To report missing or broken links and scams please 
	Contact us


Disclaimer: this site provides only links to other Tor hidden services.
We are in no way responsible for the content of those sites nor host them at our infrastructure!2022
