


HR_TAG



HOME | ADD URL | BANNER EXCHANGE | ADVERTISING | CONTACT


        VERIFIED      SCAM      NOT TESTED






















               











               





               





               





               





               





               





               





               





               






               





               





               





               





               















               


























    Ahima Search  - A Search Engine for Services on the Tor Network


    DuckDuckGo - Privacy and Simplified



    Torch Search - Torch Search  a very efficient Crawler and Search Engine


    Onionland - Search Hidden Services on the Tor Network


    Excavator - Darknet Saerch Engine


    Google Onion - Search Engine in Google Style


    Tor Search Engine - Crawl the Underground


    Venus Search - Another Deep Web Search Engine


    Lighter - Darl Side of Internet


    Torgle - The Dark Web Search Engine


    OSS - Onion Search Server


    Demon Search - Explore the Dark Web


    Phobos - Darknet Search


    G Dark - Darknet Search Engine


    Meta Gear - More than a Search Engine


    HayStak - Index with over 260,000 Onions


    7ea7 - VegV CqgD ZxjZ


    Tornet - Global Search


     






     





     





    Onion Center - Big Onlion Link Directory


    Hidden Links - Smart Deep Web Links Collection


    Hoodle -Powerful Search Engine & Links  in TOR


    Wild - Dark Web Community


    Dark Tor - Hidden Tor Wiki Directory


    Dark Dir - The most resilient Directory of working and reliable Tor Links


    Hidden Reviews -  All reviews of the DeepWeb


    Shops Dir - ShopsDir is a growing Catalogue of all DeepWeb Shops


    Pauls Onion List - 2021 Verified DarkWeb Onions


    Onion Scanner - Onion Scanner is a unique deepweb shops crawler


    Black Butterfly666 Link-Collection - Clean Link Directory



    Global Tor Links - Tons of Quality Links


    Tor Node - Quality Onion Links Directory



     





     





     






    Quality Cards - High Balance Cards 100% Working


    CC Sale - Trusted Vendor Shop


    Pre Paid Cards - 3500 USD or Euro Balance on each Card


    CC Dumps - Credit Card Info for Online Purchase


    Visa Card - Credit Cards Hacker Team


    Credit Card Center - Sells Credit Cards


    Bankor  - Prepaid & Cloned Cards


    Easy Cards - Professional carding service


    Light Money -  A group of CC experts


    Fast Money - A beautiful shop for clients that need Prepaid Cards


    Hidden Financial Services - A Store to buy basic financial products


    netAuth - Thousands of clients satisfied


    Money Tree - We are a group of international carders


    Plastic Sharks - Cloned Cards



    Add Your Link or Remove Scam Tag


     





     





    Underground Market - Cloned & Prepaid Cards / Amazon / PayPal


    Dark Way - Buy Everything you Need - Escrow Protected


    Tor Buy - Tons of products


    Royal Market - Yet Another Marketplace


    Bohemia - Multi Market


    Deep Market - Your un-secure shopping


    Hidden Marketplace - You can be not assured of your safety


    Black Market - We make shopping convenient and unsafe


    Apple Store - Only top Apple products


    Buy Real Money - BUY Money the Smart and Safe Way


    Deep Money Transfer - Most Reliable Transfers On TOR


    Bit Cards - The most trusted credit cards store




    Manticore - BEST CARDING SERVICES	PREPAID CARDS



    Add Your Link or Remove Scam Tag


     





    Guttenbergs Prints - Top-Notch Counterfeits


    Money 4 Money - High Quality Bills with Watermark and  Hologram


    Add Your Link or Remove Scam Tag


     





     





    DeepHole 10x BTC - Bitcoin Multiplier within 24 Hours


    Swedish Bitcoin Multiplier - Get Rich with Us


    Kingdom Come - Stolen Bitcoin Wallets


    Bitcoin Quantum Miner - Mining bitcoins with quantum


    Bitcoin Generator - Make Free Bitcoins


    BitAuto - BitAuto is a Decentralized and smart Bitcoin Multiplier


    Bitcoin is King - Bitcoin Wallets with Huge Amount of BTC


    Add Your Link or Remove Scam Tag


     





    Underground Market - Amazon Gift Cards $50 / $100 / $200 / $500


    Gift Hub - Gift Codes Are Made Easy


    Add Your Link or Remove Scam Tag


     





    Underground Market - Paypal Accounts with different Balances


    Easy Paypal - Easy Profit with Hacked Paypal Accounts


    Add Your Link or Remove Scam Tag


     





    RX Wholesale - UK/EU Darknet Drug Store


    Midland City - An Anonymous Drugs Marketplace


    Add Your Link or Remove Scam Tag


     





    Darkseid - Provider of Stealth Guns


    Firearms - Deep Web Weapon Shop


    Add Your Link or Remove Scam Tag



     





    Darknet Pro Hackers - A Lot of Services Provided


    Hacker Community - If you need Something Hacked Contact Them


    Nonz Hackers - Social Media / Server / Smartphone Hacking


    Add Your Link or Remove Scam Tag


     





    Bitcoin.com - Buy BTC & BCH


    Coinbase - Buy Crypto Ceurrency Easy Here


    Blockchain - Buy Bitcoin and Blockchain Wallet


    Exodus -Bitcoin & Crypto Wallet


    Electrum - Best Bitcoin Wallet


    Blender IO - Bitcoin mixing Service Secure and Anonymous


    Chip Mixer - Mixing Reinvented For Your Privacy


    Bitcoin Mixer - Bitcoin Thumbler


    Helix Light - Cleans Coins in 30 Minutes


     






    Liberty Clouds - A free Tor Based Web / File Hosting Provider


    Kowloon Hosting - Hosting with PHP & SQL - Custom Onion


    Ablative Hosting -Free Secured Clearnet and Tor .Onion Web Hosting


    Kaizushi Little Onion - This is a Hosting Service with a Shared Server


    FileForce - Fully nonymous File Sharing Service, 25MB Max-Size


    HDDoro - Image Hosting ... Hosted in Space


    MegaTor - Free Hosting with over 900 File Formats


    Pedoro - Fast Save and Secure Image Hosting


    TorPay -Share Files and Services for Money


    Tortuga - Secure & Anonymous TOR-Based File Hosting



     






    Protonmail -Secure Email Based in Switzerland


    DNMX - Anonymous Email Provider


    Crypto Dog - Private Conversations for Everyone


    Elude - Email Provider with many Features


    Mail2Tor - Free Anonymous E-Mail Service to protect your Privacy



    SecMail - Service that allows to Send and Receive Mails without Violating


    Tor Mail -Free and Secured Anonymity Mail Service


    Tor Box - Hidden Mailbox Service only accessible from TOR


     





    Dark Web Links -Latest DeepWeb News with Liinks of Darknet Markets


    Dark Web Magazine - News / Guides / Links


    DarknetLive - The Real Darknet Live


    DeepWeb Feed - Links to the best Darknet Markets


    Flashlight 2.0 - An Info Beam in the Darkweb


    Dark Web Journal - News and Reviews from the DarkNet


     






    Deep Paste - Uncensored Paste Bin


    Core - Forum about The Deep Web


    Darknet Street - See what People are talking about


    Hidden Answers - Deep Web Forum


    Galaxy 3 - Big Deep Web Forum


    Deep Paste v2 - Your Deep-Shit Hoster for Special Shit


    Arcadia - Free Retro Games


    Bible4u - Uncensored Bible for Darknet


    Stronghold - Paste Bin Directory


    We Fight Censorship - Site against Censorship


    Bitcoin Game - More you play, more you win!


    Just Another Library - Books, Courses & Art


    Dark Net Paste - Another Paste Bin


    Beneath VT - Exploring Virginia Tech's steam tunnels and beyond


    The Hidden Irony - Private Blog


    Tor Guide - Instructions for Tor / Deep Web


    Yet Another PasteBin - Post your Stuff Anonymous


    Tor Status - Tor Network Status


     
